"filename", "language", "TOML", "Rust", "JSON", "comment", "blank", "total"
"/home/helium/code/rizlium/Cargo.lock", "TOML", 3628, 0, 0, 2, 392, 4022
"/home/helium/code/rizlium/Cargo.toml", "TOML", 11, 0, 0, 4, 4, 19
"/home/helium/code/rizlium/rizlium_chart/Cargo.toml", "TOML", 15, 0, 0, 1, 5, 21
"/home/helium/code/rizlium/rizlium_chart/src/chart.rs", "Rust", 0, 178, 0, 10, 15, 203
"/home/helium/code/rizlium/rizlium_chart/src/chart/color.rs", "Rust", 0, 23, 0, 2, 4, 29
"/home/helium/code/rizlium/rizlium_chart/src/chart/easing.rs", "Rust", 0, 228, 0, 60, 18, 306
"/home/helium/code/rizlium/rizlium_chart/src/chart/line.rs", "Rust", 0, 9, 0, 1, 2, 12
"/home/helium/code/rizlium/rizlium_chart/src/chart/note.rs", "Rust", 0, 16, 0, 1, 3, 20
"/home/helium/code/rizlium/rizlium_chart/src/chart/theme.rs", "Rust", 0, 30, 0, 0, 7, 37
"/home/helium/code/rizlium/rizlium_chart/src/chart/time.rs", "Rust", 0, 4, 0, 1, 2, 7
"/home/helium/code/rizlium/rizlium_chart/src/lib.rs", "Rust", 0, 11, 0, 6, 5, 22
"/home/helium/code/rizlium/rizlium_chart/src/parse.rs", "Rust", 0, 14, 0, 0, 4, 18
"/home/helium/code/rizlium/rizlium_chart/src/parse/official.rs", "Rust", 0, 331, 0, 3, 57, 391
"/home/helium/code/rizlium/rizlium_chart/src/runtime.rs", "Rust", 0, 18, 0, 1, 3, 22
"/home/helium/code/rizlium/rizlium_chart/test_assets/take.json", "JSON", 0, 0, 36923, 0, 1, 36924
"/home/helium/code/rizlium/rizlium_render/Cargo.toml", "TOML", 29, 0, 0, 2, 3, 34
"/home/helium/code/rizlium/rizlium_render/src/lib.rs", "Rust", 0, 123, 0, 4, 16, 143
"/home/helium/code/rizlium/rizlium_render/src/line_rendering.rs", "Rust", 0, 172, 0, 10, 22, 204
"/home/helium/code/rizlium/rizlium_render_main/Cargo.toml", "TOML", 6, 0, 0, 1, 2, 9
"/home/helium/code/rizlium/rizlium_render_main/src/main.rs", "Rust", 0, 3, 0, 0, 1, 4
"Total", "-", 3689, 1160, 36923, 109, 566, 42447